ID,Age,Grade 1,Grade 2,Grade 3,Total Grades
1,17,95,90,88,273
2,18,88,91,80,259
3,18,93,86,91,270
4,17,96,87,92,275
5,18,90,93,85,268
6,19,99,87,90,276
7,18,100,95,81,276
8,17,78,80,90,248
9,17,89,90,97,276
10,17,95,91,89,275
11,19,85,92,98,275
12,18,88,75,88,251
13,19,79,84,91,254
14,19,79,90,99,268
15,19,100,97,93,290
16,18,99,93,100,292
17,17,89,90,96,275
18,19,91,88,93,272
19,17,76,80,85,241
20,18,77,81,88,246